111111111111111
100000011111011
111111011111011
111111000000011
111000011111111
111111011100111
111111000001111
111111011101111
110000011101111
110111111111111
110000000000011
110111011111111
110111011111111
100111000000001
111111111111111